111111111111111111111
100000e10000000000001
100010010000000000001
1P0010010000000000001
100010000000000000001
100010010000000000001
100010010000000000001
10001e010000000000001
111111111111111111111