11111111111111111111
10000000010000000001
10001000010000000001
1P101000000000000001
11111111111111111111